................................
................................
................................
.....&..........................
................................
................................
................................
................................
...@.......*....................
######.-.#######################
