................................................................
...................&............................................
.....&..............................*...........................
....................................#...........................
....................................#...........................
................................#...#...........................
..................@.............#...#...........................
##########################...###################################
##########################...###################################
##########################...###################################
