................................
................................
................................
.....&..........................
................................
................................
................................
................................
...@....#..*....................
######.-.#######################
