................................................................
...................&............................................
.....&..............................*...........................
....................................#...........................
....................................#...........................
....................................#...........................
..................@.................#...........................
##########################...###################################
##########################...###################################
##########################...###################################
