................................................................
...................&............................................
.....&..............................*...........................
....................................#...........................
....................................#...........................
.................................#..#...........................
..................@..............#..#...........................
##########################...###################################
##########################...###################################
##########################...###################################
