................................................................
...................&............................................
.....&..........................................................
....................................*...........................
....................................#...........................
.................................#..#...........................
..................@..............#..#...........................
##########################...###################################
##########################...###################################
##########################...###################################