................................................................
...................&............................................
.....&..........................................................
................................................................
....................................#...........................
.................................#..............................
..................@.................#...........................
##########################...###################################
##########################...###################################
##########################...###################################